,,,,~M,,,
,*,*,*,~M,*,*,
*,~,~,~,~,~B,~B,*
*,~C,~,~,~,~,~,*
*,~C,~D,D,~a,E,~F,*
*,~G,~G,I,~a,E,~F,*
*,~,~J,I,~K,K,~,*
*,~,~J,L,~L,N,~N,*
,*,*,*,~,*,*,
,,,~H,~,,,
,,,,~,,,
,,,,~,,,
