,,,,~M,,,
,*,*,*,~M,*,*,
*,~,~,~,~,~b,~b,*
*,~c,~,~,~,~,~,*
*,~c,~D,D,~a,E,~f,*
*,~G,~G,I,~a,E,~f,*
*,~,~j,I,~K,K,~,*
*,~,~j,L,~L,N,~N,*
,*,*,*,~,*,*,
,,,~H,~,,,
,,,,~,,,
,,,,~,,,
