,,,,,,,
,,,~,~M,~,,
,,,~,~M,~,,
,,,~,~,~,,
,,,~,,,,
,*,*,~,*,*,*,
*,~,B,~B,B,~C,~,*
*,~D,D,~a,,~C,~,*
*,~E,,~a,F,~F,~,*
*,~E,G,~G,I,~,~,*
*,~,~J,~J,~I,~,~K,*
*,~H,~L,~L,~,~,~K,*
