,,,,~M,,,
,*,*,*,~M,*,*,
*,~,,,~B,B,~,*
*,~,C,C,~a,,~,*
*,~d,E,,~a,F,~F,*
*,~d,E,G,~G,G,~i,*
*,~,J,J,~,K,~i,*
*,~,L,L,~,K,~,*
,*,*,*,~,*,*,
,,,~H,~,,,
,,,,~,,,
,,,,~,,,
