,,,,~M,,,
,*,*,*,~M,*,*,
*,~,,,~B,B,~,*
*,~,C,C,~a,,~,*
*,~D,E,,~a,F,~F,*
*,~D,E,G,~G,G,~I,*
*,~,J,J,~,K,~I,*
*,~,L,L,~,K,~,*
,*,*,*,~,*,*,
,,,~H,~,,,
,,,,~,,,
,,,,~,,,
