,,,,~M,,,
,*,*,*,~M,*,*,
*,B,,C,~C,,D,*
*,B,,E,~F,F,D,*
*,G,G,E,~a,,,*
*,,I,,~a,J,J,*
*,,I,K,~K,L,,*
*,,,,~,L,,*
,*,*,*,~,*,*,
,,,~H,~,,,
,,,,~,,,
,,,,~,,,
