,,,,~M,,,
,*,*,*,~M,*,*,
*,~B,,C,~C,,*,*
*,~B,,D,~D,,~E,*
*,~F,F,G,~a,,~E,*
*,~,I,G,~a,J,~J,*
*,~,I,K,~K,L,~,*
*,~,,N,~N,L,~,*
,*,*,*,~,*,*,
,,,~H,~,,,
,,,,~,,,
,,,,~,,,
