,,,,,,,
,,,~,~M,~,,
,,,~,~M,~,,
,,,~,~,~,,
,,,~,,,,
,*,*,~,*,*,*,
*,~B,B,~,C,~,~,*
*,~D,,~,C,~E,~E,*
*,~D,F,~F,,~G,~,*
*,~D,I,~J,J,~G,~,*
*,~,~I,~a,~K,~K,~L,*
*,~N,~N,~a,~,~H,~L,*
