,,,,~M,,,
,*,*,*,~M,*,*,
*,B,C,C,~a,,,*
*,B,D,,~a,E,E,*
*,,D,F,~F,G,I,*
*,J,J,K,~,G,I,*
*,L,L,K,~,,N,*
*,,,O,~O,O,N,*
,*,*,*,~,*,*,
,,,~H,~,,,
,,,,~,,,
,,,,~,,,
