,,,,~M,,,
,*,*,*,~M,*,*,
*,~B,,,~a,C,~C,*
*,~B,D,D,~a,,~,*
*,~,E,,~F,F,~G,*
*,~,E,I,~I,J,~G,*
*,~K,K,L,~,J,*,*
*,~,,L,~,N,~N,*
,*,*,*,~,*,*,
,,,~H,~,,,
,,,,~,,,
,,,,~,,,
