,,,,,,,
,,,~,~M,~,,
,,,~,~M,~,,
,,,~,~,~,,
,,,~,,,,
,*,*,~,*,*,*,
*,~B,B,~C,C,~D,~,*
*,~E,,~F,F,~D,~,*
*,~E,,~a,G,~I,~I,*
*,~J,J,~a,G,~,~,*
*,~,~K,~L,~L,~,~N,*
*,~H,~K,~O,~O,~O,~N,*
