,,,,~M,,,
,*,*,*,~M,*,*,
*,~b,,,~a,C,~C,*
*,~b,D,D,~a,E,~,*
*,~,F,G,~G,E,~,*
*,~,F,I,~J,J,*,*
*,~K,K,I,~,,~,*
*,~,L,L,~N,N,~,*
,*,*,*,~,*,*,
,,,~H,~,,,
,,,,~,,,
,,,,~,,,
