,,,,,,,
,,,~,~M,~,,
,,,~,~M,~,,
,,,~,~,~,,
,,,~,,,,
,*,*,~,*,*,*,
*,~B,C,~C,,~D,~E,*
*,~B,F,~G,G,~D,~E,*
*,~,F,~,I,~J,~J,*
*,*,K,~K,I,~,~,*
*,~,~,~a,~L,~L,~,*
*,~H,~,~a,~N,~N,*,*
