,,,,~M,,,
,*,*,*,~M,*,*,
*,~B,,,~a,C,~C,*
*,~B,D,D,~a,E,~,*
*,~,F,G,~G,E,~,*
*,~,F,I,~J,J,*,*
*,~K,K,I,~,,~,*
*,~,L,L,~N,N,~,*
,*,*,*,~,*,*,
,,,~H,~,,,
,,,,~,,,
,,,,~,,,
