,,,,~M,,,
,*,*,*,~M,*,*,
*,*,B,B,~a,,,*
*,C,C,D,~a,,,*
*,E,,D,~F,F,*,*
*,E,G,G,~,I,J,*
*,E,K,L,~L,I,J,*
*,,K,,~,N,N,*
,*,*,*,~,*,*,
,,,~H,~,,,
,,,,~,,,
,,,,~,,,
