,,,,~M,,,
,*,*,*,~M,*,*,
*,,,B,~C,C,*,*
*,D,,B,~E,E,F,*
*,D,G,G,~a,,F,*
*,,*,,~a,I,I,*
*,J,J,K,~K,L,,*
*,,,N,~N,L,,*
,*,*,*,~,*,*,
,,,~H,~,,,
,,,,~,,,
,,,,~,,,
