,,,,~M,,,
,*,*,*,~M,*,*,
*,,,B,~B,B,C,*
*,,,D,~E,E,C,*
*,F,F,D,~a,G,G,*
*,I,J,J,~a,,,*
*,I,K,,~L,L,,*
*,*,K,N,~N,O,O,*
,*,*,*,~,*,*,
,,,~H,~,,,
,,,,~,,,
,,,,~,,,
