,,~,~M,~,,,
,,~f,~M,~,,,
,,~f,~,~k,,,
,,~e,~j,~k,,,
,,~e,~j,~l,,,
,,~d,~i,~l,,,
,,~d,~i,~m,,,
,,~c,~h,~m,,,
,,~c,~h,~n,,,
,,~b,~g,~n,,,
,,~b,~g,~o,,,
,,~H,~a,~o,,,
,,~,~a,~,,,
