,,,,~M,,,
,*,*,*,~M,*,*,
*,B,C,C,~D,D,E,*
*,B,,F,~G,G,E,*
*,I,I,F,~a,,,*
*,,J,,~a,K,K,*
*,,J,L,~L,N,,*
*,,O,O,~,N,,*
,*,*,*,~,*,*,
,,,~H,~,,,
,,,,~,,,
,,,,~,,,
