,,,,~M,,,
,*,*,*,~M,*,*,
*,~b,C,C,~a,,~,*
*,~b,D,,~a,E,~E,*
*,~,D,F,~F,G,~i,*
*,~J,J,K,~,G,~i,*
*,~L,L,K,~,,~n,*
*,~,,O,~O,O,~n,*
,*,*,*,~,*,*,
,,,~H,~,,,
,,,,~,,,
,,,,~,,,
