,,,,~M,,,
,*,*,*,~M,*,*,
*,~,,B,~C,C,*,*
*,~d,,B,~E,E,~f,*
*,~d,G,G,~a,,~f,*
*,~,*,,~a,I,~I,*
*,~J,J,K,~K,L,~,*
*,~,,N,~N,L,~,*
,*,*,*,~,*,*,
,,,~H,~,,,
,,,,~,,,
,,,,~,,,
