,,,,~M,,,
,*,*,*,~M,*,*,
*,~b,,C,~C,,*,*
*,~b,,D,~D,,~e,*
*,~F,F,G,~a,,~e,*
*,~,I,G,~a,J,~J,*
*,~,I,K,~K,L,~,*
*,~,,N,~N,L,~,*
,*,*,*,~,*,*,
,,,~H,~,,,
,,,,~,,,
,,,,~,,,
