,,,,,,,
,,,~,~M,~,,
,,,~,~M,~,,
,,,~,~,~,,
,,,~,,,,
,*,*,~,*,*,*,
*,~,B,~B,C,~C,~D,*
*,~,,~,E,~,~D,*
*,*,F,~F,E,~,~D,*
*,~,,~a,G,~G,~G,*
*,~I,~J,~a,~,~K,~,*
*,~I,~J,~L,~L,~K,~H,*
