,,,,,,,
,,,~,~M,~,,
,,,~,~M,~,,
,,,~,~,~,,
,,,~,,,,
,*,*,~,*,*,*,
*,~B,C,~C,D,~D,~,*
*,~B,,~a,E,~E,~F,*
*,~G,G,~a,I,~,~F,*
*,~,J,~,I,~K,~K,*
*,~,~J,~L,~L,~N,~,*
*,~O,~O,~H,~,~N,~,*
