,,,,~M,,,
,*,*,*,~M,*,*,
*,~b,,,~a,C,~C,*
*,~b,D,D,~a,,~,*
*,~,E,,~F,F,~g,*
*,~,E,I,~I,J,~g,*
*,~K,K,L,~,J,*,*
*,~,,L,~,N,~N,*
,*,*,*,~,*,*,
,,,~H,~,,,
,,,,~,,,
,,,,~,,,
