,,,,,,,
,,,~,~M,~,,
,,,~,~M,~,,
,,,~,~,~,,
,,,~,,,,
,*,*,~,*,*,*,
*,~,B,~C,C,~,~,*
*,~,B,~D,D,~E,~,*
*,~F,F,~a,,~E,~,*
*,~,,~a,G,~I,~I,*
*,~J,~K,~K,~G,~,~L,*
*,~J,~,~N,~N,~H,~L,*
