,,,,~M,,,
,*,*,*,~M,*,*,
*,*,,,~a,B,B,*
*,C,D,D,~a,,E,*
*,C,F,,~G,G,E,*
*,,F,I,~I,J,,*
*,K,K,L,~,J,*,*
*,,,L,~,N,N,*
,*,*,*,~,*,*,
,,,~H,~,,,
,,,,~,,,
,,,,~,,,
